+++++++++++++++++++++++++++++++++++++++++++++++
+                +                            +
+    H           +                            +
+                +                            +
+++++++++++++    +                            +
+  P  +     +    +                            +
+     +     +    +                            +
+     +     +    +                            +
+     +     +    +                            +
+     +     +    +                            +
+     +     +    +                            +
+     +     +    +                            +
+     +     +    +                            +
+     +     +    +                            +
+     +++++++    +                            +
+		   +                            +
+		   +                            +
++++++++++++++++++                            +
+                                             +
+                                             +
+                                             +
+                                             +
+                                             +
+                                             +
+                                             +
+                                             +
+                                             +
+                                             +
+                                             +
+                                             +
+                                             +
+++++++++++++++++++++++++++++++++++++++++++++++